intrinsic functions in fortran 77: https://www.obliquity.com/computer/fortran/intrinsic.html

NR: Common, 
SMIN:  Common, Sucharameter für kleinste Rechteckgröße (REAL)
SMAX:  Common, Suchparameter für größte Rechteckgröße (REAL)
TOL: Common, Toleranz der seitlichen Abweichung im Quadrat (REAL)
NHO: Parameter, 1700 (max. Anzahl der Pfosten, Dimensioniert die Arrays)
NSO: Parameter, 33, Dimensioniert die Pointer beim Sortieren, ist die maximale Anzahl der Suchquadrate auf x oder y
FIL: Var Text 25 Zeichen für Dateipfad zum Einlesen
WX(NHO): Array von x, w für ?
WY(NHO): Array von y, w für ?
IX(NHO): Array vom Typ integer? für x
IY(NHO): Array vom Typ integer? für y
IW1(NHO): ???
IWI(NHO): ???
Name(NHO): Array mit Text-Element 6 Zeichen (Name des Pfostens)
CW (NHO): Array mit Text-Element 6 Zeichen für ???
IP(0:NSO, NSO) Array mit 2 Dimensionen, 1. mit Werten von 0 bis NSO, das zweite 1 bis NSO
IP1 (0:NSO) Array mit 1 Dimension, Elemente 0 bis NSO 
IHR: Integer mit 2 dig., hour
IMIN: Integer mit 2 dig., minute
ISEC: Integer mit 2 dig., second
I100TH: Integer mit 2 dig., mil. second
JHR: Integer mit 2 dig., hour
JMIN: Integer mit 2 dig., minute
JSEC: Integer mit 2 dig., second
J100TH: Integer mit 2 dig., mil. second
IHUGE: eine maximale Integer, nach googlen 2147483647
NH: Anzahl der Pfosten, wird beim Einlesen der Daten erstellt
XSIZE: große der Fläche in x (aus Koordinaten abgeleitet)
YSIZE: größe der Fläche in y (-"-)
GETTIM: intrinsische Funktion, liefert Zeitstempel
IFIX: intrinsische Funktion, wandelt REAL in Integer
MAXO: Archaic form of MAX(), instrinsic function
LX: größte Wert aus der Division von xsize (Fläche) / max. Rechteckgröße, mindestens 1, obergrenze der Rechtecke in der Fläche
LY: größte Wert aus der Division von ysize (Fläche) / max. Rechteckgröße, mindestens 1
XSQ: Anzahl der Suchquadrate auf x
YSQ: Anzahl der Suchquadrate auf y

